R  1000 1000
NO   ./tex.XPM   
SO ./wood.xpm
WE ./wall_2.xpm 
EA ./wall_1.xpm
S ./sprite_1.xpm
F 255,255,255
C 0,0,0

11111111111111111111111111
100100000000000000000000111111111
111111111011000001110000000000001
100000000011000001110111111111111
11110111111111011100000010001
11110111111111011101010010201
11000000110101011100000010001
10002000000000001100000010201
10000000000000001101010010001
11000001110101011111011110N0111
11110111 1110101 101111010001
11111111 1111111 111111111111
